# Syntax Coloring Map For Button_TT Library

Font_TT	KEYWORD1
getFont	KEYWORD2
getTextSizeX	KEYWORD2
getTextSizeY	KEYWORD2
setTextSize	KEYWORD2
charBounds	KEYWORD2
getTextBounds	KEYWORD2
getTextBoundsAndOffset	KEYWORD2
newTextBoundsAndOffset	KEYWORD2
getTextAlignCursor	KEYWORD2
Button_TT	KEYWORD1
initButton	KEYWORD2
getOutlineColor	KEYWORD2
setOutlineColor	KEYWORD2
getFillColor	KEYWORD2
setFillColor	KEYWORD2
getInverted	KEYWORD2
drawButton	KEYWORD2
drawIfChanged	KEYWORD2
press	KEYWORD2
release	KEYWORD2
isPressed	KEYWORD2
justPressed	KEYWORD2
justReleased	KEYWORD2
contains	KEYWORD2
delta	KEYWORD2
Button_TT_label	KEYWORD1
getTextColor	KEYWORD2
setTextColor	KEYWORD2
getTextAlign	KEYWORD2
setTextAlign	KEYWORD2
getFont	KEYWORD2
setFont	KEYWORD2
getLabel	KEYWORD2
setLabel	KEYWORD2
getDegreeSymbol	KEYWORD2
setLabelAndDrawIfChanged	KEYWORD2
Button_TT_int8	KEYWORD1
Button_TT_int16	KEYWORD1
Button_TT_uint8	KEYWORD1
Button_TT_uint16	KEYWORD1
getValue	KEYWORD2
setValue	KEYWORD2
setValueAndDrawIfChanged	KEYWORD2
valueIncDec	KEYWORD2
Button_TT_arrow	KEYWORD1
getOrientation	KEYWORD2
Button_TT_Collection	KEYWORD1
clear	KEYWORD2
registerMasterProcessFunc	KEYWORD2
registerButton	KEYWORD2
unregisterButton	KEYWORD2
press	KEYWORD2
release	KEYWORD2
